Now_18_(Portuguese_series)
EMI / Sony BMG / Universal

CD 1
Amy Winehouse : "Tears Dry On Their Own"
Alicia Keys : "No One"
Timbaland feat. OneRepublic : "Apologize"
Duffy : "Mercy"
Gabriella Cilmi : "Sweet About Me"
Da Weasel : "Toque-Toque"
Rihanna : "Don't Stop The Music"
Justin Timberlake : "LoveStoned / Think She Knows"
Bob Sinclar feat. Steve Edwards : "Together" (Radio Edit)
Mika : "Big Girl (You Are Beautiful)"
Moby : "Disco Lies"
The B-52's : "Funplex"
Kylie Minogue : "In Your Arms"
Nelly Furtado feat. Juanes : "Te Busque"
Gianna Nannini : "Meravigliosa Creatura" (Album Version)
Balla : "Tudo (Em Queda Livre)"
Paulo Gonzo : "Leve Beijo Triste" (Versão 2007)
Pedro Abrunhosa & Os Bandemónio : "Pontes Entre Nós"
Mafalda Veiga : "Estrada"

CD 2
Sara Bareilles : "Love Song" (Album Version)
Leona Lewis : "Bleeding Love" (Album Version)
Enrique Iglesias : "Alguien Soy Yo
David Fonseca : "Kiss Me, Oh Kiss Me"
Lenny Kravitz : "I'll Be Waiting"
Colbie Caillat : "Bubbly" (Album Version)
Clã : "Sexto Andar"
Rita Redshoes : "Dream On Girl"
Brandi Carlile : "The Story" (Album Version)
Tokio Hotel : "Ready, Set, Go!"
30 Seconds To Mars : "The Kill (Bury Me)"
The Kooks : "Always Where I Need To Be"
Shout Out Louds : "Tonight I Have To Leave It"
Klepht : "Por Uma Noite"
Plain White T's : "Hey There Delilah"
Goldfrapp : "A&E"
Mesa : "Boca Do Mundo"
T.T. feat. Nuno Guerreiro : "Vem Cá (Dá-me O Teu Mundo Outra Vez)"
Jay Sean : "Ride It"
