Now_14_(Portuguese_series)
EMI / Sony BMG / Universal

CD 1
Kelly Clarkson : "Because Of You"
Coldplay : "Talk"
Melanie C : "First Day Of My Life"
Paulo Gonzo : "Sei-te De Cor"
Corinne Bailey Rae : "Put Your Records On"
Robbie Williams : "Advertising Space"
Eros & Anastacia : "I Belong To You"
Simon Webbe : "No Worries"
Bob Sinclar feat. Gary Pine : "Love Generation"
M.A.U. : "It's Lovely"
Backstreet Boys : "I Still"
Mesa : "Vício De Ti"
Pólo Norte : "A Dança"
Daniela Mercury : "Topo Do Mundo"
Within Temptation : "Angels"
KT Tunstall : "Suddenly I See"
David Fonseca : "Hold Still"
Clã : "Problema de Expressão" (Ao Vivo)
Ivete Sangalo : "Abalou"

CD 2
Sergio Mendes : "Mas Que Nada"
Beyoncé : "Check On It"
Black Eyed Peas : "My Humps"
Guardiões Do Subsolo : "Popless"
Rihanna : "If It's Lovin'"
Patrice : "Soul Storm"
Gentleman : "Send A Prayer"
Ben Harper : "Better Way"
Franz Ferdinand : "Do You Want To"
Depeche Mode : "Suffer Well"
Goldfrapp : "Number 1"
Macaco : "Sidereal"
The Pussycat Dolls : "Stickwitu"
Boss AC : "Princesa (Beija-me Outra Vez)"
Matafix : "Big City Life"
Jamie Foxx : "Unpredictable"
Mind Da Gap : "Não Stresses"
P!nk : "Stupid Girls"
Placebo : "Song To Say Goodbye"
Lordi : "Hard Rock Hallelujah"
