Now_16_(Portuguese_series)
EMI / Sony BMG / Universal

CD 1
Da Weasel : "Dialectos Da Ternura"
Gwen Stefani Feat. Akon : "Sweet Escape"
Mika : "Grace Kelly"
Robbie Williams With Pet Shop Boys : "She's Madonna"
Simon Webbe : "Coming Around Again"
Outlandish : "I Only Ask of God"
Justin Timberlake : "What Goes Around...Comes Around" (Radio Edit)
Timbaland Feat. Justin Timberlake & Nelly Furtado : "Give It to Me"
Avril Lavigne : "Keep Holding On"
James Morrison : "You Give Me Something" (Eg Version)
Gavin DeGraw : "Follow Through"
Corinne Bailey Rae : "I'd Like To"
Sam The Kid : "Poetas De Karaoke"
JoJo : "Too Little Too Late"
Jamelia : "Beware of the Dog"
Tracey Thorn : "It's All True" (Radio Edit)
Buraka Som Sistema Feat. Petty : "Yah!"
LCD Soundsystem : "North American Scum" (Radio Edit)
Blasted Mechanism : "All the Way"
Breaking Benjamin : "The Diary of Jane"

CD 2
Nelly Furtado : "Say It Right"
Pink : "Nobody Knows" (Main Version)
Shakira Featuring Carlos Santana : "Illegal"
Coldplay : "The Hardest Part"
Keane : "Nothing in My Way"
Take That : "Patience"
EZ Special : "Sei Que Sabes Que Sim"
Oioai : "Jardim Das Estátus"
The Fray : "How To Save A Life"
Kubb : "Grow"
Ricardo Azevedo : "Entre O Sol E A Lua"
Evanescence : "Lithium" (Album Version - Clean)
Christina Aguilera : "Hurt"
Mundo Secreto : "Essência (A Liberdade)"
Simply Red : "So Not Over You"
André Sardet : "Quando Eu Te Falei De Amor"
Norah Jones : "Thinking About You"
Filarmónica Gil : "Ponto De Rebuçado"
Orishas : "Hay Un Son"
K-Os : "Sunday Morning"

